- HESOYAM - Health, Armor, $250k, Repairs car
- BAGUVIX - (Semi)Infinite Health
- CVWKXAM - Infinite Oxygen
- LXGIWYL - Weapon Set 1
- PROFESSIONALSKIT - Weapon Set 2
- UZUMYMW - Weapon Set 3
- STICKLIKEGLUE - Perfect Vehicle Handling
- ANOSEONGLASS - Adrenaline Mode
- FULLCLIP - Infinite Ammo, No Reloading
- TURNUPTHEHEAT - Increase Wanted Level +2
- TURNDOWNTHEHEAT - Clear Wanted Level
- BTCDBCB - Fat Body
- BUFFMEUP - Muscular Body
- KVGYZQK - Skinny Body
- AEZAKMI - Disable Wanted Level
- BRINGITON - Six Star Wanted Level
- WORSHIPME - Maximum Respect
- HELLOLADIES - Maximum Sex Appeal
- VKYPQCF - Maximum Stamina
- PROFESSIONALKILLER - Hitman Level for all Weapon Stats
- NATURALTALENT - Maximize All Vehicle Skill Stats
- SPEEDITUP - Fast Motion
- SLOWITDOWN - Slow Motion
- AJLOJYQY - People attack each other with golf clubs
- BAGOWPG - Have a bounty on your head
- FOOOXFT - Pedestrians hunt you
- GOODBYECRUELWORLD - Suicide
- BLUESUEDESHOES - Elvis Models for People
- BGLUAWML - People attack with Rocket Launchers
- LIFESABEACH - Beach Party Mode
- ONLYHOMIESALLOWED - Gang Members Mode
- BIFBUZZ - Gang Control
- NINJATOWN - Ninja Theme
- BEKKNQV - Women Talk to You
- CJPHONEHOME - Big Bunny Hop
- KANGAROO - Mega Jump
- STATEOFEMERGENCY - Riot Mode
- CRAZYTOWN - Funhouse Mode
- SJMAHPE - Recruit Anyone
- ROCKETMAYHEM - Recruit Anyone
- CPKTNWT - Blow Up All Cars
- WHEELSONLYPLEASE - Invisible car
- ZEIIVG - All green lights
- YLTEICZ - Aggressive Drivers
- LLQPFBN - Pink CArs
- IOWDLAC - Black Cars
- EVERYONEISPOOR - All Cheap Cars
- EVERYONEISRICH - All Fast Cars
- CHITTYCHITTYBANGBANG - Flying Cars
- FLYINGFISH - Flying Boats
- JCNRUAD - Cars Blow Up Easily
- SPEEDFREAK - All Cars Have Nitro
- BUBBLECARS - Moon Car Gravity
- OUIQDMW - Free Aim While Driving
- GHOSTTOWN - Reduced Traffic
- FVTMNBZ - Country Vehicles
- BMTPWHR - Country Vehicles and People